
DEF         textures/default-fallback-texture.xpm

F1          textures/sushi-ninja/wooden-wall-1.xpm
C1          textures/sushi-ninja/wooden-wall-1.xpm

W01         textures/sushi-ninja/concrete-wall.xpm
W02         textures/sushi-ninja/brick-wall.xpm
W03 	    textures/sushi-ninja/street-vendor-1.xpm
W04 	    textures/sushi-ninja/street-vendor-2.xpm
W05         textures/sushi-ninja/ground2.xpm
W06         textures/sushi-ninja/bamboo-wall-2.xpm
W07         textures/sushi-ninja/pink-window-1.xpm
W08         textures/sushi-ninja/pink-window-1.xpm
W09         textures/sushi-ninja/pink-window-1.xpm

DOOR_01     textures/doors/door-orange.xpm
DOOR_01_S   textures/doors/door-side-orange.xpm
DOOR_02    	textures/sushi-ninja/shoji-door.xpm
DOOR_02_S  	textures/sushi-ninja/shoji-door-sides.xpm
DOOR_03     textures/sushi-ninja/bamboo-wall-2.xpm
DOOR_03_S   textures/sushi-ninja/bamboo-wall-2.xpm

ED1    	    textures/doors/door-cyan.xpm


111112111111111111112
1S  $12    24F    2 22
1   12B   23G       2
1   12    222     D 2
1   12      |      22
11-112      2  2    2
2           2222222 2
2           G32 F 2A2
2         C F42   222 
2           222     2
222222 222222       2
5        5          1
5        5          1
5        |         A1
5        5          1
5        5          1
55555555551-111-111-111
1        1   1   1    1
1        1   1   1    1
111111111111111111111 1
666666666666666666666 1
6A]             6     1
666666666666666   66666
66666666666666666666666