
DEF         textures/default-fallback-texture.xpm

F1          textures/sushi-ninja/ground.xpm
C1          textures/sushi-ninja/pink-window-2.xpm

W01         textures/sushi-ninja/wooden-wall-1.xpm
W02         textures/sushi-ninja/pink-window-2.xpm
W03 	    textures/sushi-ninja/pink-window-1.xpm
W04 	    textures/sushi-ninja/pink-window-1.xpm
W05         textures/sushi-ninja/pink-window-1.xpm
W06         textures/sushi-ninja/sakura-wallpaper.xpm
W07         textures/sushi-ninja/pink-window-1.xpm
W08         textures/sushi-ninja/pink-window-1.xpm
W09         textures/sushi-ninja/pink-window-1.xpm

DOOR_01    	textures/sushi-ninja/shoji-door.xpm
DOOR_01_S  	textures/sushi-ninja/shoji-door-sides.xpm
DOOR_02     textures/doors/door-orange.xpm
DOOR_02_S   textures/doors/door-side-orange.xpm
DOOR_03     textures/bookshelf.xpm
DOOR_03_S   textures/bookshelf.xpm

ED1    	    textures/doors/door-cyan.xpm

111111111111111111111
1  $     1          O7
1        1          6
1        1          P7
1        1          6
1        1          O7
1ABCD FGHI JKL      6
1A                  P7
1A                  6
1      N            O7
33333333331111-111111
1  $     1          1
1        2          1
1        4          1
1        5          1
1        1          1
1ABCD FGHI JKL      1
1Aaaaaaaaaaaaaaaaaaa1
111111134215122323333