F  10, 10, 10
C  10, 10, 10

W1     	textures/simonkraft/bookshelf_02.xpm
W2      textures/wolfenstein/red_brick.xpm
W3 		textures/blue-wall.xpm
W4 		textures/blue-wall-skeleton.xpm
W5      textures/bookshelf.xpm
W6      textures/simonkraft/respawn_anchor_side3.xpm
W7      textures/ceiling.xpm
W8      textures/simonkraft/bookshelf_01.xpm
W9      textures/test_floor.xpm


111166111111111111111111111111111111111111111111111
1      1343434116666666615555555   1              1
1 E    |      |    s   1      5    1              1
1      13434341        |      5    1              1
111-2221  1   2        1      5   11              1
1      1   1           15555555   11              1
1      1111111         11111111    |              1
1 s          1         |    1      1              1
1    999     1      s  1    1      1              1
1      1     1         1    1     11              1
1      1     1    h    1    1      1              1
1      1111111         111111     11              1
1               t      a    a      1              1
99-999999999999999999999999999999999999999999999-99
9                                                 9
9                                                 9
999999999999999999999999999999999999999999999999999
