




NO textures/wall-2-n.xpm
EA textures/wall-2-e.xpm
SO textures/wall-2-s.xpm
WE textures/wall-2-w.xpm

F 50,50,50
C 153,204,255

111111111111111111111
10s000000000000000001
1000000000000000011001
100011000000000000001
10000000000N000000001
100000100000000000001
100000000000000001001
100000100000000000001
101000001000000000001
111111111111111111111
