
NO textures/wall-2-n.xpm
EA textures/wall-2-e.xpm
SO textures/wall-2-s.xpm
WE textures/wall-2-w.xpm

F 50,50,50
C 153,204,255

11111111111111111111111111111111111111111111111
10001111111000v00000000000000000000000000000001
10E0|0|00|0000v000|0000000000000000000000000001
11111111101000v000|0000000000000000000000000001
100000000000000000|0000000000000000000000000001
100111000v0000000000000000000000000000000100001
10000001v00110100000000000000000000000000000001
10000000000000v00110100000000000000000000000001
10001100000000v00000100000000000000000000000001
10000000000000000000100000000000000000000000001
1000001000s000v00000100000000000000000000000001
10000000000000v00100100000000000000000000000001
10000010000000v00000100000000000000000000000001
10100000100000v00000100000001000000000000000001
10000000000000|00100100000000000000000000000001
10000010000000v00000100000000000000000000000001
10100000100000v00000100000000000000000000000001
11111111111111111111111111111111111111111111111
