   WE                            textures/wolfenstein/grey_stone.xpm
NO      textures/wolfenstein/red_brick.xpm



SO textures/wolfenstein/red_brick.xpm

F      255,    0,     0

EA textures/wolfenstein/wood.xpm

C  255,    255,     255

111111111111111111111111111111111111111111111111111111111
10000000000000000000000000000001ssssssssssssssssssssssss1
10000000000000000000000000000001ssssssssssssssssssssssss1
10000000000000000000000000000001ssssshsssassssssssssssss1
1000000000000000000000000000000|0N0p000000000000000000011
1000s000000000s00000s0000000000100000000000000000a0000001
10000000000q00s00000s000011111111111111111111111111111111
100000s0000000000000s0q00|0000000100000000000000000000001
1000000s0s00000000s00000011111110100000000000000000000001
10000000000s0000s0000000000000010100111000000000000000001
100000s000000s0s00000000000000010100100000000000000000001
10000s000000000000000000000000010111100000000000000000001
100000000000000000000000000000010000000000000000000000001
111111111111111111111111111111111111111111111111111111111
