   WE                            textures/wolfenstein/grey_stone.xpm
NO      10,    10,     10



SO textures/wolfenstein/red_brick.xpm

F      255,    0,     0

EA textures/wolfenstein/wood.xpm

C 255, 0, 0

111111111111111111111111111111111111111111111111111111111
100000000000000000000000000000000000000000000000000000001
100000000000000000000000000000000000000000000000000000001
100000000000000000000000000000000000000000000000000000001
10000000000000s000000000000000000000000000000000000000001
100000000000000000000000000000000000000000000000000000001
100000000000000000000000000000000000000000000000000000001
100000000000000000000000000000000000000000000000000000001
100000000000000000000000000000000000000000000000000000001
100000000000000000000000000000000000000000000000000000001
100000000000000000000000000000000000000000000000000000001
100000000000000000000000000000N00000000000000000000000001
10000000h000000000000000000000000000000000000000000000001
100000000000000000000000000000000000000000000000000000001
100000000000000000000000000000000000000000000000000000001
111111111111111111111111111111111111111111111111111111111
